ResuPro Admin Panel Seed List (Templates & Categories)
Generated from resume-builder source

Resume Categories (label + slug)
- Professional (slug: professional)
- Modern (slug: modern)
- Corporate (slug: corporate)
- Minimal (slug: minimal)
- Creative (slug: creative)
- Monochrome (slug: monochrome)
- Elegant (slug: elegant)
- Geometric (slug: geometric)
- Line (slug: line)
- Photo (slug: photo)
- Feminine (slug: feminine)
- Classic (slug: classic)
- Bold (slug: bold)
- Aesthetic (slug: aesthetic)
- Tech (slug: tech)
- Colorful (slug: colorful)
- Dark (slug: dark)
- Retro (slug: retro)
- Playful (slug: playful)
- Classy (slug: classy)
- Purple (slug: purple)
- Fancy (slug: fancy)
- Infographic (slug: infographic)
- Gold (slug: gold)
- Grid (slug: grid)
- Gradient (slug: gradient)
- Abstract (slug: abstract)
- Border (slug: border)
- Rectangle (slug: rectangle)
- New (slug: new)
- Luxury (slug: luxury)
- Illustrated (slug: illustrated)
- Vibrant (slug: vibrant)
- Organic (slug: organic)
- Fun (slug: fun)
- Logo (slug: logo)
- Light (slug: light)
- Shapes (slug: shapes)
- Watercolor (slug: watercolor)
- Digital (slug: digital)
- Pastel (slug: pastel)
- Frame (slug: frame)
- Collage (slug: collage)
- Cute (slug: cute)
- Grunge (slug: grunge)
- Modular (slug: modular)
- Pattern (slug: pattern)

Resume Templates (base templates)
- Classic (id: classic)
- Modern (id: modern)
- Impact (id: impact)
- Minimal (id: minimal)
- Tech Modern (id: tech-modern)
- Minimalist Photo (id: minimalist-photo)
- Minimalist Professional (id: minimalist-professional)
- ATS (id: ats)
- Executive (id: executive)
- Professional (id: professional)
- Creative (id: creative)

Resume Templates (category-generated)
- Professional Studio (id: cat-professional) [category: professional]
- Modern Prime (id: cat-modern) [category: modern]
- Corporate Edition (id: cat-corporate) [category: corporate]
- Minimal Flow (id: cat-minimal) [category: minimal]
- Creative Line (id: cat-creative) [category: creative]
- Monochrome Stack (id: cat-monochrome) [category: monochrome]
- Elegant Aura (id: cat-elegant) [category: elegant]
- Geometric Wave (id: cat-geometric) [category: geometric]
- Line Vista (id: cat-line) [category: line]
- Photo Core (id: cat-photo) [category: photo]
- Feminine Studio (id: cat-feminine) [category: feminine]
- Classic Prime (id: cat-classic) [category: classic]
- Bold Edition (id: cat-bold) [category: bold]
- Aesthetic Flow (id: cat-aesthetic) [category: aesthetic]
- Tech Line (id: cat-tech) [category: tech]
- Colorful Stack (id: cat-colorful) [category: colorful]
- Dark Aura (id: cat-dark) [category: dark]
- Retro Wave (id: cat-retro) [category: retro]
- Playful Vista (id: cat-playful) [category: playful]
- Classy Core (id: cat-classy) [category: classy]
- Purple Studio (id: cat-purple) [category: purple]
- Fancy Prime (id: cat-fancy) [category: fancy]
- Infographic Edition (id: cat-infographic) [category: infographic]
- Gold Flow (id: cat-gold) [category: gold]
- Grid Line (id: cat-grid) [category: grid]
- Gradient Stack (id: cat-gradient) [category: gradient]
- Abstract Aura (id: cat-abstract) [category: abstract]
- Border Wave (id: cat-border) [category: border]
- Rectangle Vista (id: cat-rectangle) [category: rectangle]
- New Core (id: cat-new) [category: new]
- Luxury Studio (id: cat-luxury) [category: luxury]
- Illustrated Prime (id: cat-illustrated) [category: illustrated]
- Vibrant Edition (id: cat-vibrant) [category: vibrant]
- Organic Flow (id: cat-organic) [category: organic]
- Fun Line (id: cat-fun) [category: fun]
- Logo Stack (id: cat-logo) [category: logo]
- Light Aura (id: cat-light) [category: light]
- Shapes Wave (id: cat-shapes) [category: shapes]
- Watercolor Vista (id: cat-watercolor) [category: watercolor]
- Digital Core (id: cat-digital) [category: digital]
- Pastel Studio (id: cat-pastel) [category: pastel]
- Frame Prime (id: cat-frame) [category: frame]
- Collage Edition (id: cat-collage) [category: collage]
- Cute Flow (id: cat-cute) [category: cute]
- Grunge Line (id: cat-grunge) [category: grunge]
- Modular Stack (id: cat-modular) [category: modular]
- Pattern Aura (id: cat-pattern) [category: pattern]

Cover Letter Categories
- None defined in the app (single list of templates).
- If the Admin Panel requires categories, use: Modern, Professional, Creative

Cover Letter Templates
- Modern Clean (id: modern)
- Classic Professional (id: professional)
- Creative Impact (id: creative)

CV Templates (optional, if you want to manage CVs in the Panel)
- Academic CV (id: academic-cv)
- Executive CV (id: executive-cv)
- Minimalist Professional CV (id: minimalist-professional-cv)
